62,62,62,64,62,62,62,64,62,62,62,64,62,62,62,64,62,62,62,64,62,62,62,64,62,62,62,64,62,62,62,64
63,63,63,64,63,63,63,64,63,63,63,64,63,63,63,64,63,63,63,64,63,63,63,64,63,63,63,64,63,63,63,64
31,31,31,64,31,31,31,64,31,31,31,64,31,31,31,64,31,31,31,64,31,31,31,64,31,31,31,64,31,31,31,64
39,39,47,74,39,47,39,74,39,39,39,74,39,39,47,74,39,39,39,74,39,39,39,74,39,39,47,74,47,39,39,74
3,4,5,4,3,4,5,4,3,4,5,4,3,4,5,4,3,4,5,4,3,4,5,4,3,4,5,4,3,4,5,4
11,12,13,12,11,12,13,12,11,12,13,12,11,12,13,12,11,12,13,12,11,12,13,12,11,12,13,12,11,12,13,12
19,20,21,49,19,20,21,49,19,20,21,49,19,20,21,49,19,20,21,49,19,20,21,49,19,20,21,49,19,20,21,49
27,28,29,68,16,0,18,68,27,28,29,68,16,0,18,68,27,28,29,68,16,0,18,68,27,28,29,68,16,0,18,68
35,36,37,68,24,0,26,68,35,36,37,68,24,0,26,68,35,36,37,68,24,0,26,68,35,36,37,68,24,0,26,68
35,36,37,68,24,0,26,68,35,36,37,68,24,0,26,68,35,36,37,68,24,0,26,68,35,36,37,68,24,0,26,68
43,44,45,68,32,0,34,68,43,44,45,68,32,0,34,68,43,44,45,68,32,0,34,68,43,44,45,68,32,0,34,68
51,73,53,76,40,41,42,76,51,52,53,76,40,41,42,76,51,52,53,76,40,41,42,76,51,52,53,76,40,41,42,76
3,4,5,4,3,4,5,4,3,4,5,4,3,4,5,4,3,4,5,4,3,4,5,4,3,4,5,4,3,4,5,4
11,12,13,12,11,12,13,12,11,12,13,12,11,12,13,12,11,12,13,12,11,12,13,12,11,12,13,12,11,12,13,12
48,49,50,28,48,49,50,28,48,49,50,28,48,49,50,28,48,49,50,28,48,49,50,28,48,49,50,28,48,49,50,28
