62,62,62,64,38,38,24,0,0,26,68,68,24,0,0,26,68,68,68,24,0,0,26,68,68,24,0,0,26,38,38,64
63,63,63,64,38,38,24,0,0,26,68,68,24,0,0,26,68,68,68,24,0,0,26,68,68,24,0,0,26,38,38,64
31,31,31,64,38,38,24,0,0,26,68,68,24,0,0,26,68,68,68,24,0,0,26,68,68,24,0,0,26,38,38,64
39,39,47,74,46,46,24,0,0,26,68,68,24,0,0,26,68,68,68,24,0,0,26,68,68,24,0,0,26,46,46,74
3,4,5,5,56,57,24,0,0,26,68,68,24,0,0,26,68,68,68,24,0,0,26,68,68,24,0,0,26,56,57,3
11,12,13,13,56,57,24,0,0,26,68,68,24,0,0,26,68,68,68,24,0,0,26,68,68,24,0,0,26,56,57,11
19,20,21,50,30,30,24,0,0,26,68,68,24,0,0,26,68,68,68,24,0,0,26,68,68,24,0,0,26,30,30,48
27,28,29,69,38,38,24,0,0,26,68,68,24,0,0,26,68,68,68,24,0,0,26,68,68,24,0,0,26,38,38,67
35,36,37,69,38,38,24,0,0,26,68,68,24,0,0,26,68,68,68,24,0,0,26,68,68,24,0,0,26,38,38,67
35,36,37,69,38,38,24,0,0,26,68,68,24,0,0,26,68,68,68,24,0,0,26,68,68,24,0,0,26,38,38,67
43,44,45,69,38,38,32,0,0,34,68,68,32,0,0,34,68,68,68,32,0,0,34,68,68,32,0,0,34,38,38,67
51,52,53,77,46,46,40,41,41,42,76,76,40,41,41,42,76,76,76,40,41,41,42,76,76,40,41,41,42,46,46,75
3,4,5,4,3,4,4,4,4,4,4,4,4,4,4,4,4,4,4,4,4,4,4,4,4,4,4,4,4,4,5,4
11,12,13,12,11,12,12,12,12,12,12,12,12,12,12,12,12,12,12,12,12,12,12,12,12,12,12,12,12,12,13,12
48,49,50,28,48,49,50,28,48,49,50,28,48,49,50,28,48,49,50,28,48,49,50,28,48,49,50,28,48,49,50,28
